.....##...
.###......
.......#..
.......#..
.......#..
..........
..####..#.
..........
##........
.......###