.....###..
.##......
..........
.#........
.#...####.
.#........
.......###
..........
..........
.##....#..